NO ./assets/textures/wall_n.xpm
SO ./assets/textures/wall_n.xpm
WE ./assets/textures/wall_n.xpm
EA ./assets/textures/wall_n.xpm

F 26,13,0
C 230,242,255

111111111111111111111111111111111
100011001000000000110000000000001
111100011011000001110000000000001
10100010100100000000000S000000001
111111111011000001110000000000001
100000000011000001110111111111111
111101111111110111000000100010001
111101111111110111010100100000001
110000001101010111000000100000111
100000000000000011000000100110001
100000000000000011010100100000001
110000011101010111110111100000111
111101110111010101011110100000101
111111111111111111111111111111111